6,6,6,6,6,6,6,6,9,9,9,9,9,9,9,6,6,6,6,6,6,6,6,6,6,6,6,6,6,6
6,6,6,6,6,6,6,6,6,9,9,9,9,9,9,6,6,6,6,6,6,6,6,6,6,6,6,6,6,6
5,5,5,5,5,6,6,6,6,6,9,9,9,9,6,6,6,6,5,5,5,5,5,5,5,5,5,6,6,6
6,6,6,6,5,6,6,6,6,6,6,6,6,6,6,6,6,6,5,6,6,6,6,6,6,6,5,6,6,6
6,6,6,6,5,6,6,6,6,6,6,6,6,6,6,6,6,6,5,6,6,6,6,6,6,6,5,6,6,6
6,6,6,6,5,6,6,6,6,6,6,6,6,6,6,6,6,6,5,6,6,6,6,6,6,6,5,6,6,6
6,6,6,6,5,6,6,6,6,6,6,6,6,6,6,6,6,6,5,6,6,6,6,6,6,6,5,5,5,5
6,6,6,6,5,6,6,6,6,6,6,6,5,5,5,5,5,5,5,6,6,6,6,6,6,6,6,6,6,6
6,6,6,6,5,6,6,6,6,6,6,6,5,6,6,6,6,6,6,6,6,6,6,6,6,6,6,6,6,6
6,6,6,6,5,6,6,6,6,6,6,6,5,6,6,6,6,6,6,6,6,6,6,6,6,6,6,6,6,6
6,6,6,6,5,6,6,6,6,6,6,6,5,6,6,6,6,6,6,6,6,6,6,9,9,6,6,6,6,6
6,6,6,6,5,6,6,6,6,6,6,6,5,6,6,6,6,6,6,6,9,9,9,9,9,9,6,6,6,6
6,6,6,6,5,5,5,5,5,5,5,5,5,6,6,6,6,6,6,9,9,9,9,9,9,9,9,6,6,6
6,6,6,6,6,6,6,6,6,6,6,6,6,6,6,6,6,6,6,9,9,9,9,9,9,9,9,6,6,6
6,6,6,6,6,6,6,6,6,6,6,6,6,6,6,6,6,6,6,9,9,9,9,9,9,9,6,6,6,6
6,6,6,6,6,6,6,6,6,6,6,6,6,6,6,6,6,6,6,6,9,9,9,9,9,6,6,6,6,6